USERS:
id	Integer	INTEGER	
email	String	VARCHAR	
password  String	VARCHAR	
role	String	VARCHAR	
created_at	DateTime

AGENTS:
id	String	VARCHAR
owner_id	Integer	INTEGER
status	String	VARCHAR
gpu_model	String	VARCHAR
ram_total	String	VARCHAR
last_heartbeat	DateTime	DATETIME

JOBS:
id	Integer	INTEGER
title	String	VARCHAR
status	String	VARCHAR
original_code_url	String	VARCHAR
original_req_url	String	VARCHAR
original_data_url	String	VARCHAR
owner_id	Integer	INTEGER
created_at	DateTime	DATETIME

SUBTASKS:
id	Integer	INTEGER
job_id	Integer	INTEGER
assigned_to	String	VARCHAR
status	String	VARCHAR
chunk_file_url	String	VARCHAR
result_file_url	String	VARCHAR
completed_at	DateTime	DATETIME	